  #####
###   #
# $ # ##
# #  . #
#    # #
## #   #
 #@  ###
 ######