  #####
###   ##
# $ #  #
#  .#$ #
# #  # #
##   . #
 #@  ###
 #####
