  #######
  #  .  #
### ##$ ###
#   $@   #
# #  ##  #
#  .. $# #
##########
